10,10
checkers_128.png
t,grass.jpg
t,gravel.jpg
1,1,1,1,1,1,1,1,1,1
1,1,1,1,1,1,1,1,1,1
1,1,1,1,1,1,1,1,1,1
1,1,1,1,2,1,1,1,1,1
1,1,1,2,2,2,1,1,1,1
1,1,1,1,2,1,1,1,1,1
1,1,1,1,2,1,1,1,1,1
1,1,1,1,1,2,2,1,1,1
1,1,1,1,1,1,1,1,1,1
1,1,1,1,1,1,1,1,1,1
